mng: spk zox idm gnz
meu: vas rmg
wat: jyx ppw
tnq: oew
voa: iad dgc rdq
uea: cmz
cwz: uny vwc bcq
hwo: gpp rga ehq xos kfl
tke: eoi xcj xvr mqy tbw
ipo: fbo jja kfq
ntb: puy yna yon
bkz: foi oau
dgc: uic frp sso xny sew mft qoe mhi goa fye kyp ssn mmr cji dxs uea nhd nca qtw ave xfv lia
jda: out
ozf: lhb bam
ibl: out
nut: sjs tdc cko
miw: wdt iva
xgs: qdc uxq
epk: iml dkm voa sqo
wxr: axn dvh xue urx
wnr: cnr fbm gnt
luz: nme gpn waq nve
rdq: xny sew uic sso mhi mft goa dxs nhd nca kyp mmr cji oio ave xfv
fst: wwr lne ezd vwx
qaa: uye
rop: out
kmy: abs tyg
gpn: btm pdo
skp: het jja fbo fme
fmx: fvn mwv
osv: rup foi you
aoy: fgj ryi
sxu: nmc
akv: zze rnt
mto: ico ond uko
ljf: vok uvd
hkp: out
jqg: sdp uwp
xjx: ldg qcw iaa
qnb: cwz
xcl: eec jfn bcw
wae: qkt pdj
nvr: het jja fme kfq
zox: tbw mqy xvr eoi xcj
fyi: eoi tbw mqy xvr
ejg: yvn
uyb: voa bgn
fvn: shh
sta: iad
aci: zhd qvw miw gil
ufo: wed vhd
frh: hmz rzx psc
qwv: quw
kbl: wat kpj bnt gif
vok: foi you rup
mno: kbl cxi seb
maw: vid vgk fyi
zmx: gzz
rau: uye vas hvd wqa
iml: dgc iad
uye: vpr otu loa inv kvh dcd sbd fak bwj mwz jyt gie hyl xut bgo rwq rnp mia
sbd: jiw zmo eey las
zlc: lag
mwz: bkn jzq ckc ekr
yvn: xcj
ezt: idf zox idm gnz
blo: out
dxs: pql
aio: mhk wql ylj wxb mxs fcv wsz akq wae vue nmh xwb iah hwm gab tmt grn vot nhk ozf aci
oul: out
tdc: bcq
goa: urs khg xed
upu: foi rup
yhk: qke
dgz: ruu gyf hro rbf
vgk: xvr mqy xcj eoi
tfh: vok moy
nwu: qld fjw
dxp: dgr fvu
vid: tbw xvr xcj
idm: tbw mqy xcj
tva: fbo het fme
pdo: xjx dcx ips
fwb: see ipo
vun: rup gdx you foi
cee: seb
onh: oul roh abt qur
oiy: sqo voa bgn dkm
zgq: hvd rmg uye vas
kxg: knq nkc mvh pwn
njx: out
jap: gdx rup you foi
dvp: wwv sdp quw
ume: bdr hem
nkn: vuc
gox: pqi fag
qjb: vtw zgq
otu: xwx yvo ode luc
wdt: tcc qxn qgp jcd
quw: abs tyg
eeb: iad
vtw: vas hvd rmg
wok: dxy mwv
iqz: eoi xvr mqy
uxq: kut wpi zsr
jzz: out
gvm: mdk iaa
qkt: nke
wjd: hkl yfl rdd sla xcl
tbw: qks zjk tpw dap nbx idx ofs qiy xgs oju
qvw: upa
zhd: upa iva
cji: wao mab pql
dkm: dgc rdq iad
yna: het jja fbo
fjw: dgc
qtw: sid nqs oyw voe
esj: jsu njx vdv
wph: bkz kfk
bgo: fep xuz
bnk: lsp mml
hmi: frh dsf fka hta
uba: eoi xcj
mhi: hfp nuj
yck: oul
nca: oyw
gpq: ago kac wph kur
lhb: nvr vbg skp tva
fak: xuz mng fep ezt
psc: dgc rdq
rlg: ejg ckc ekr
nwq: kfq
kyp: gux rgt nuj
wff: rvp gpq
xvx: dxy mwv
dgx: mic ikg yqm
idf: tbw mqy xvr xcj
mzn: mic nip ikg yqm
mvh: rdq
mck: out
nmc: qaa meu aia
gil: wdt
mku: dir fsa tdh stm nbe
xgb: fjw
lsr: glz gfh
kxn: fag
xny: xed khg
qxb: epk uyb oiy fft
bnt: jyx
vas: rnp gie fak wnf sbd
fep: idm zox idf spk gnz
osb: jzt wxb akq wsz mxs fcv vue ili wae iah wql mhk ylj nhk ozf aci gab tmt qmb grn vot
ryf: sqo voa
eip: gex kxg
svr: ddh gcr xbq osb aio
ppq: vwx nfh
psi: dgc iad
grn: lhb bam
loc: duv tju wwx fnw lnq
eoi: nbx ume exs ofs idx oju xgs rpj dap tpw qiy zlc exw qks zjk wff dya rav ayh
ckc: iqz tke
mml: fbo jja het kfq fme
zjo: mno cee
xuz: gnz idf zox idm
abs: urx
ltd: fnw wwx
gfh: fbo het kfq
yfl: eec
bwj: ejg
rmg: kvh dcd ivg vpr otu inv wnf loa fak bwj sbd rlg gie mwz hzb jyt rwq rnp bgo mia hyl
kxr: cko sjs
dyy: maw rab
btm: gvm xjx ips
kfl: jeg
hsf: pqi
ovw: nwq yon puy
ibp: aia akn qaa meu
xwb: smp whp
xfv: nuj hfp gux rgt
zqt: aia fbv
pdj: dpf nke lsr oww
yqe: eoi xcj
kvh: ode yvo luc xwx xsx
hem: fdd
duv: ovw
zsv: onh
uhq: hmi ohv myj
hro: eei
dac: osv xkd nsl
jik: ago wph kur snw
dcx: ldg mdk qcw iaa
wao: yur gox
opz: vid fyi
zhk: fft uyb ryf epk
rxt: xey jgn hwo tbb
vuc: ibl hkp rop jzz
coh: mvh nkc knq
kkz: nwu xgb ajy ocv
uvd: oau you foi gdx rup
vlo: rbf ruu hro
xvg: fjw eeb
bdr: lbi yri
wve: ais
zsr: tfh ljf
cfi: hkl rdd
tcc: jja
gzz: eoi xcj mqy xvr tbw
bgr: rdq dgc
bgn: iad dgc
yxb: qnj zsv dds wve urm
urs: zgq
oej: gex
jci: wwr nfh lne vwx
inv: huh xuz mng ezt
ips: ldg
nme: btm
rbf: zoe
zze: cfc yqe
kwo: kxg
jyx: out
dsf: hmz
rvp: kur snw wph
gpw: tiz gwj
cuz: coh
fag: hvd wqa vas uye
gex: mvh
yad: bnt gif wat kpj
wql: pou whp
ubs: jja het fbo
uis: see mml
yur: ojx
lbi: you rup gdx
ohe: yri
bcw: iad dgc rdq
mic: gzz
jzq: yvn tke iqz
qfk: qnj dds zsv urm
eei: ulj ziz htn
upa: ubs qxn qgp
iah: bnk
ayh: bdr bjo ohe
sdp: tyg
stm: lhl jqg qwv
mia: jiw las eey
wwv: abs wxr
gwl: dcx gvm xjx
xos: upu xvy
dix: you oau
htn: esj cfp xrn
ago: bkz kfk
nkc: iad
you: ssr lmn pri koy dxp
cxi: gif wat
hwm: pdj qkt jay
nbe: skv qwv dvp
hta: rzx hmz
hnl: awd wcw
hfp: mzi fst
aws: mqy xcj eoi
wwx: ntb axg ovw
ddh: fcv wsz mxs akq jzt nmh xwb iah ili wae ylj mhk wql nhk aci ozf tmt hwm gab grn qmb
fdd: gdx rup you foi
lnq: ovw
nbx: rvp jik
kac: ikh jap
jay: dpf nke oww
ond: tbw mqy xvr eoi xcj
uwu: yad kbl
shh: rdq iad
voe: hgq
kid: kxg coh
fbo: ojt wok wjd hhf xvx
mhk: ltd wuy
vbg: jja fbo
jgn: ehq xos rga
fme: kid eip acv uhq fmx qxb cuz oej
iaa: mra blo
vdv: out
uic: yld cmz hnl
gyf: qcy gpw eei pkv
wcw: zqt ioz
ofs: jik
kut: bym tfh
gie: zze lqq
loa: eey jiw zmo mto
wsz: whp kcd
ryi: adw vuc pbp
rav: lag
wwr: rau wnq
tiz: qbf esj cfp xrn
xxj: hvd rmg vas
whp: qnb
trm: ruu gyf
urm: onh
puy: fme het jja fbo
skv: kmy
mpt: xgb xvg ajy
pts: yad kbl cxi seb
xoy: yqm ikg zmx nip
yjb: fft epk oiy
xwx: jlm
fgj: pbp
lhl: uwp
dds: yck ais
tdh: qwv lhl dvp
fcv: loc
vot: ltd
jeg: rup gdx oau you foi
xey: kfl gpp
wnf: mzn xoy
qnj: onh yck ais
ikh: you rup
ihr: jja fbo
qiy: dac cns
oww: glz lea
dya: bjo
waq: btm gwl pdo
kfq: wok oej fmx cfi zhk wyl wuq kid acv fsk kwo uhq yyu eip hhf cuz qxb xol ojt yjb xvx gnw
rut: zjo fvu
tmt: pou kcd smp
mqy: exw zlc rxt oju xgs dap tpw
qld: iad rdq dgc
nuj: fst ppq jci
bkn: tke iqz kne uba
tpw: qdc zhu uxq
dxy: sta eil shh
mwv: sta shh
rfh: cnr gnt
akn: wqa rmg vas uye
zoe: tiz
zhu: wpi kut
hnp: vhd aoy wed
fka: bgr
sbi: iva wdt
zmo: ond uko
rpj: qdc uxq
nip: gzz
ylj: jay pdj qkt
exw: gpq
jcd: fme kfq het jja
mft: hnl
xcj: exw zlc rxt qiy rav ayh wff dya qks ofs idx rpj xgs nbx ume exs dap tpw
gqd: tdc cwz cko
oau: pri dgz amp koy mro htq ssr trm sjt rfd twk luz rut jxd wnr
cfc: xcj mqy tbw
fbm: yxb dtd qfk
xvy: gdx you foi
txv: gdx oau foi
ohv: dsf frh bxc hta
xol: spu hmi
jlm: opz rab maw
wqw: dir
fgi: tbw
lia: rgt gux hfp
qdc: wpi
gpp: xvy
ulj: qbf esj xrn mbn
lsp: fbo fme
ico: mqy xvr tbw xcj
ave: hnl
pkv: tiz ziz ulj htn
ioz: aia fbv akn meu
awd: zqt nmc ibp ioz
nhd: mom mab pql
roh: out
hwh: lsp ipo
bxc: bgr hmz psc
exs: jgn tbb hwo xey
qcw: blo
kne: xvr tbw eoi
gnt: qfk dtd
seb: bnt kpj wat
xrn: jsu jda njx vdv mck
dgr: pts kmx
akq: pgx lhb bam
wqa: xut hyl rnp mia bwj mwz tsx jyt ivg
kur: kfk jap
jiw: ond
cmz: sxu wcw
spk: xvr xcj
luc: dyy
rup: jxd lmn api wnr ssr vlo rfd sjt dxp dgz amp mro rfh htq
wnq: vas uye rmg wqa
kmx: cxi jrd seb kbl
adw: rjy hkp rop jzz
oew: hvd wqa rmg uye vas
fnw: ntb ovw
xsx: jlm dyy mxr
jfn: rdq dgc
mxr: rnu opz
gif: jyx ppw vdd
moy: oau you foi gdx
yri: gdx rup foi oau
jja: zhk uhq wyl xvx yyu cfi yhk
dtd: qnj zsv dds urm wve
rga: xvy jeg
yzd: out
qur: out
wbd: hvd rmg
ojx: vas rmg hvd
foi: mku wnr jxd rut dxp sjt trm vlo amp koy htq dgz pri
qmb: uis
hey: aoy vhd
xed: dlh zgq
pbp: rop hkp ibl
yvo: mxr dyy jlm
huh: zox
ehq: upu
vwc: fbo fme
fbv: rmg wqa vas
gab: zhd gil qvw miw sbi
oyw: gkt xxj hgq
qxn: fme jja het
eec: rdq dgc iad
nsl: rup oau you foi
pgx: nvr ihr
gnw: qke mpt kkz
wyl: mpt
sjt: fsa stm
gcr: xwb nmh iah ili vue mxs wsz fcv akq jzt ylj wql aci ozf nhk grn qmb tmt gab
sla: eec bcw yxd
ocv: fjw
abt: out
ssn: voe wvz sid
nmh: zhd sbi
api: hnp
qcy: htn gwj ziz
nhk: fwb bnk uis
vhd: nkn ryi qqt fgj
ajy: eeb
dpf: glz gfh lea
vue: jay pdj
bam: ihr nvr skp tva
nht: out
tyg: urx xue dvh axn
axn: out
rgt: jci mzi
smp: kxr fcy gqd nut
qks: qdc
ili: wuy ltd
jsu: out
ais: qur oul roh nht abt
nke: glz
lgi: vhd
zaf: xvr tbw eoi
bjo: yri dix
tsx: ekr bkn
rwq: mzn
mom: gox tnq kxn hsf
vpr: yvo luc xwx xsx
rjy: out
fvu: cee uwu pts kmx
sew: mab wao mom
xut: dgx mzn
amp: cnr
fft: iml dkm voa sqo
zjk: zhu qdc uxq
oio: sid wvz nqs oyw
lag: txv osv
gnz: eoi xcj tbw xvr mqy
cns: xkd nsl osv
urx: out
het: uhq hhf xvx wuq wjd kwo fsk xol qxb cuz fmx
mro: fvu
mzi: ezd vwx
knq: dgc
wuq: myj
vdd: out
dlh: uye vas hvd wqa rmg
sid: xxj
gkt: vas wqa
pqi: hvd uye
kcd: kxr gqd nut
axg: nwq puy yon
gwj: qbf mbn
dcd: mzn dgx
dap: hem ohe bdr
uny: jja kfq fme
xvr: qiy tpw rxt rav dya
qbf: jda vdv mck njx
glz: kfq
hhf: fvn ebe mwv
xkd: foi
hkl: yxd
see: jja fbo
rnu: fyi
yld: sxu awd
fsa: jqg qwv dvp skv
dir: lhl
qke: ocv nwu
ezd: jiy wnq
fcy: cko tdc cwz
cko: bcq
sso: cmz hnl
iad: ave qtw qoe kyp mmr frp uic dxs uea xny
kfk: rup gdx oau foi
hmz: rdq dgc iad
yxd: rdq dgc iad
qqt: pbp vuc
frp: hfp
qgp: kfq fme jja
rdd: bcw
drk: tbw mqy
ode: dyy
myj: bxc fka
kpj: ppw vdd
eil: iad rdq dgc
aia: hvd rmg wqa vas uye
lne: wnq jiy wbd rau
ojt: yfl xcl hkl
yqm: aws fgi gzz
hzb: bkn ejg ckc
ivg: jiw eey las
lmn: hey lgi hnp
uwp: wxr
lqq: cfc drk kpn
mmr: wvz sid
ikg: fgi
hvd: kvh ivg vpr inv loa fak bwj sbd gie tsx hzb bgo xut dcd otu akv rlg mwz rnp rwq mia hyl
spu: hta
fsk: mwv dxy ebe
khg: dlh vtw zgq
ekr: tke uba
wxb: pdj
bcq: kfq jja het fbo
lea: jja fme
sqo: dgc rdq
xbq: iah xwb nmh vue ili wae akq wsz fcv mxs jzt wxb wql mhk ozf nhk vot qmb tmt gab hwm
jiy: uye rmg
rfd: hnp ufo hey
xue: out
mxs: pou
qyw: gwl
pou: kxr gqd nut fcy
snw: jap kfk bkz
vwx: wnq rau wbd jiy
sjs: vwc
yyu: hmi
jrd: gif
eey: zaf ond
wpi: tfh bym
fye: qjb khg
rab: vgk vid fyi
jxd: gnt
hyl: luc xwx
ebe: psi
mdk: blo yzd mra
gux: ppq
las: ico uko
pri: tdh fsa
ruu: pkv eei
cfp: jda
pwn: iad rdq dgc
rzx: dgc iad
nve: pdo gwl
ziz: cfp xrn mbn qbf
mab: hsf kxn yur tnq gox
dvh: out
ppw: out
gdx: twk rut luz lmn jxd mku wnr dgz pri amp koy htq rfh trm ssr vlo wqw rfd sjt dxp
yon: kfq fbo het
hgq: uye vas rmg
cnr: qfk yxb
tbb: ehq xos kfl rga gpp
mra: out
ssr: nve nme
jyt: mzn
jzt: hwh
wed: qqt nkn
kpn: mqy xvr
twk: waq nve qyw gpn
ldg: blo
nfh: rau
pql: gox tnq yur hsf
oju: lag dac
bym: vun moy
htq: stm nbe
koy: zjo fvu
mbn: vdv mck jsu jda
rnt: cfc drk
idx: jgn hwo tbb xey
wuy: duv fnw lnq
acv: sla xcl yfl rdd hkl
tju: ntb axg
iva: qgp qxn ubs tcc
uko: xcj eoi mqy
nqs: xxj
rnp: rnt lqq zze
wvz: gkt xxj
qoe: urs xed
